ก|ถ|ภ|ฎ
ข|บ|ป|พ
ฃ|ข|ค|ว
ค|ต|ด|ฅ
ฅ|ค|ต|ด
ฆ|ม|ง|พ
ง|จ|ค|ด
จ|ง|ว|ท
ฉ|จ|ค|อ
ช|ซ|ข|ห
ซ|ช|ฟ|ป
ฌ|ณ|ญ|ธ
ญ|ฒ|ฌ|ณ
ฎ|ฏ|ด|ต
ฏ|ฎ|ถ|ฤ
ฐ|ถ|ท|ฑ
ฑ|ธ|ท|ฒ
ฒ|ฑ|ธ|ท
ณ|น|ฒ|ฌ
ด|ค|ต|ฅ
ต|ฅ|ด|ค
ถ|ฑ|ธ|ท
ท|ถ|ฑ|ธ
ธ|ท|ถ|ฑ
น|ม|บ|พ
บ|ม|ป|ษ
ป|บ|ฝ|ฟ
ผ|พ|น|ย
ฝ|ฟ|ภ|พ
พ|ฝ|ฟ|ภ
ฟ|ภ|พ|ฝ
ภ|พ|ฝ|ฟ
ม|ป|น|บ
ย|ม|ป|น
ร|ล|ว|อ
ล|ร|ส|ศ
ว|อ|ด|ฮ
ศ|ษ||ค|ต
ษ|บ|น|ย
ส|ศ|ษ|ล
ห|ท|น|ย
ฬ|พ|ฟ|ฝ
อ|ด|ล|ค
ฮ|อ|ด|ถ
